...####
..##.#.#####
.##..###..##
##.........#
#...@..#..##
###..###..##
..#..#.....#
.##.##.#.###
.#......#.#.
.#.....###..
.#...#..#...
############