...####.....
..##.#.#####
.##..###..##
##...#...#.#
#...@..#..##
###..#######
..#..#...#.#
.##.##.#.###
.#......#.#.
.#..#..###..
.#...#..##..
############