............
..##.#......
.##..###....
##...#...#.#
#...@..#..##
###.........
..#..#...#.#
.##.##.#.###
.#......#.#.
.#..#..###..
.#...#..##..
............